#######Q################################
##      ################################
## ###########              ############
##      ###### ### #### ################
####### ###### ### #### ################
####### ###### ######## ################
####    ###### ######## ################
#### ######### ######## ################
####           ######## ################
####################### ################
####################### ################
#############           ################
############# ##########################
############# ##########################
############# ########             #####
#######       ######## ########### #####
####### ############## ########### #####
####### ############## ########### #####
#######                ########### #####
##################################M#####